WWWWWWWWWWWWWWWWWWWWWWWWWWW
WP W WW WWW DDD DDD DD D PW
W D  D M W   D   D   D  D W
WD W D W W W D W D W D W DW
WDPPPPPPPPPPPPPPPPPPPPPPPDW
WDW W W W W W W W W W W WDW
WD WWWWWW    K         J DW
WD W D W D W D W D W D W DW
W D  D   D   D   D   D  D W
WP D DD DDD DDD DDD DD D PW
WWWWWWWWWWWWWWWWWWWWWWWWWWW